{

    "tileset" : "level_tile.png",

    "terrain" : [

        [1, 1, 1, 1, 1, 1, 1, 1, 1,  1,  1,  1,  1,  1,  1],

        [1, 3, 2, 3, 4, 5, 4, 5, 4,  5,  4,  3,  2,  3,  1],

        [1, 4, 1, 4, 1, 4, 1, 4, 1,  4,  1,  4,  1,  4,  1],

        [1, 3, 4, 3, 2, 3, 4, 3, 2,  3,  4,  3,  4,  3,  1],

        [1, 4, 1, 4, 1, 4, 1, 4, 1,  4,  1,  4,  1,  4,  1],

        [1, 3, 2, 3, 4, 5, 4, 5, 4,  5,  4,  3,  2,  3,  1],

        [1, 2, 1, 2, 1, 2, 1, 2, 1,  2,  1,  2,  1,  2,  1],

        [1, 3, 2, 3, 4, 5, 4, 5, 4,  5,  4,  3,  2,  3,  1],

        [1, 4, 1, 4, 1, 4, 1, 4, 1,  4,  1,  4,  1,  4,  1],

        [1, 3, 4, 3, 2, 3, 4, 3, 2,  3,  4,  3,  4,  3,  1],

        [1, 4, 1, 4, 1, 4, 1, 4, 1,  4,  1,  4,  1,  4,  1],

        [1, 3, 2, 3, 4, 5, 4, 5, 4,  5,  4,  3,  2,  3,  1],

        [1, 1, 1, 1, 1, 1, 1, 1, 1,  1,  1,  1,  1,  1,  1]
  
    ]

}
